border_size=1
usage=map

Mm          , Mm          , Mm          , Mm          , Hh          , Hh^Fp       , Hh^Fp       , Hh^Fp       , Hh          , Mm          , Mm          , Mm          , Mm          , Mm          , Mm          , Hh          , Mm          , Hh          , Hh          , Hh          , Hh          , Mm          , Mm          , Mm          , Hh          , Hh          , Hh          , Gs^Fp       , Gg          , Gs^Fp       , Mm          , Hh          , Hh          , Mm          , Hh          , Hh          , Hh          , Mm          , Hh          , Hh^Fp       , Hh          , Hh^Fp       , Hh^Fp       , Hh          , Hh          , Mm          , Mm          , Mm          , Mm          , Mm          , Mm          , Ha          , Mm          , Ms          , Ms          
Mm          , Mm          , Hh^Fmw      , Hh          , Hh          , Hh          , Hh          , Hh^Fp       , Hh^Fp       , Mm          , Mm          , Hh          , Mm          , Hh          , Mm          , Hh          , Hh          , Mm          , Hh          , Gg          , Gg          , Gg          , Gg          , Hh          , Gg          , Gg          , Gg          , Gs^Fp       , Gg          , Gg          , Gg          , Gg          , Gg          , Hh          , Gg          , Gg          , Gg          , Hh          , Gg          , Hh          , Hh          , Hh^Fp       , Hh          , Hh          , Hh          , Hh          , Mm          , Mm          , Hh          , Mm          , Mm          , Mm          , Mm          , Mm          , Mm          
Hh          , Hh          , Gg          , Gg          , Hh          , Hh          , Gg          , Hh^Fmf      , Gs^Fp       , Hh^Fmf      , Hh          , Hh          , Mm          , Ww          , Hh          , Hh          , Mm          , Hh          , Gg          , Gg          , Gg          , Gg          , Gg          , Hh          , Gg          , Gg          , Gg          , Gg          , Gg          , Gg          , Gg          , Gg          , Gg          , Gg          , Gg          , Gg          , Gg          , Gg          , Hh          , Hh          , Mm          , Hh          , Hh          , Mm          , Hh          , Hh^Fp       , Mm          , Mm^Xm       , Mm          , Mm          , Mm          , Mm          , Hh          , Mm          , Hh          
Gs^Fmf      , Gg          , Gs^Fp       , Gg          , Hh          , Gg          , Gg          , Hh          , Gs^Fmf      , Gg          , Gg          , Hh          , Hh          , Hh^Vo       , Hh          , Hh          , Hh          , Hh          , Gg          , Gg          , Gg          , Gg          , Gg          , Gg          , Gg          , Gg          , Gg          , Gg          , Gg          , Gg          , Gg          , Gg          , Gg          , Gg          , Wwf         , Wwf         , Wwf         , Hh          , Ww          , Hh          , Mm          , Mm          , Mm          , Hh          , Mm          , Mm          , Mm          , Mm          , Mm^Xm       , Mm          , Mm          , Hh          , Hh          , Hh          , Hh          
Gg          , Gg          , Gs^Fp       , Gg          , Gg          , Hh          , Hh          , Gg          , Gg          , Hh          , Gg^Vo       , Rd          , Rd          , Hh          , Gg^Vo       , Hh          , Gg          , Gg          , Gg          , Gg          , Ww          , Ww          , Ww          , Gg          , Gg          , Gg          , Gg          , Gg          , Ww          , Ww          , Wwf         , Ds          , Ww          , Ww          , Gg          , Gg          , Hh          , Ww          , Hh          , Ww          , Ww          , Mm          , Mm          , Mm          , Mm          , Mm          , Hh^Fdw      , Mm          , Mm          , Mm          , Mm          , Hh^Fdw      , Mm          , Mm          , Mm          
Gs^Fp       , Gs^Fp       , Gs^Fp       , Gs^Fp       , Gs^Fp       , Gg          , Gg          , Gg          , Gg          , Gg          , Rd          , Rd          , Dd          , Gg^Vo       , Rd          , Gg          , Gg          , Gg          , Gg          , Ww          , Ds          , Ds          , Gg          , Ww          , Ww          , Ww          , Wwf         , Ww          , Gg          , Gg          , Ds          , Wwf         , Gg          , Gg          , Gg          , Hh          , Hh          , Hh          , Mm          , Mm          , Wwf         , Gg          , Mm          , Hh^Vhh      , Gg          , Hh          , Hh          , Mm          , Hh          , Hh^Fdw      , Hh          , Mm          , Hh^Fdw      , Hh          , Hh          
Gg          , Gg          , Gg          , Gg          , Gg          , Gs^Fp       , Gg          , Gg          , Gg          , Gg          , Gg          , Dd^Fi       , Gg          , Gg          , Hh^Fp       , Hh          , Gg          , Gg          , Gg          , Ww          , Ww          , Ww          , Ww          , Gg          , Gg          , Gg          , Gg          , Gg          , Hh          , Gg          , Ds          , Ww          , Ce          , Gg          , Gg          , Gg          , Gg          , Hh^Fdw      , Mm          , Mm^Xm       , Mm          , Mm          , Hh          , Hh          , Hh          , Mm          , Hh          , Hh          , Gg          , Hh          , Mm          , Mm          , Mm          , Hh          , Hh          
Gg          , Gg          , Ww          , Gg          , Gg          , Gs^Fp       , Gg          , Gg          , Gg          , Gg          , Hh^Fp       , Gg          , Gg          , Gg          , Gg          , Gg          , Gg          , Gg          , Gg          , Gg          , Gg          , Ds          , Ww          , Ww          , Gg          , Gg          , Hh^Vc       , Gg          , Mm          , Gg          , Re          , Ww^Bw/      , Ww          , Gg          , Gg          , Gg          , Hh          , Hh^Vhh      , Mm          , Mm          , Hh          , Mm          , Hh          , Mm          , Mm          , Mm          , Hh          , Gg          , Gg          , Gg          , Hh          , Mm          , Mm          , Hh          , Gg          
Ww          , Ww          , Ds          , Ww          , Ww          , Gg          , Gg          , Gg          , Gg          , Gg          , Ce          , Gg          , Co          , Ko          , Ww^Bw|      , Ww          , Wo          , Gg          , Gg          , Gg          , Ds          , Ds          , Ww          , Ds          , Gg          , Gg          , Hh          , Hh          , Hh          , Hh          , Re          , Gg          , Gg          , Ww          , Ww          , Ww          , Mm          , Mm          , Hh          , Mm          , Hh          , Mm          , Mm          , Mm          , Mm          , Mm          , Mm          , Hh          , Hh          , Gg          , Gg          , Hh          , Mm          , Hh          , Gg          
Gs^Fmw      , Gg          , Gg          , Gg          , Ds          , Ww          , Ww          , Gg          , Gg          , Ce          , Wwf         , Wwf         , Wo          , Wo          , Re          , Ce          , Gg          , Wo          , Ww          , Wwf         , Ww          , Ww          , Gg          , Gg          , Gg          , Hh          , Gg          , Gg          , Gg          , Gg          , Re          , Gg          , Gg          , Gg          , Re^Gvs      , Re^Gvs      , Hh          , Mm^Vhh      , Hh          , Mm          , Gg          , Mm          , Mm          , Hh          , Hh^Fp       , Hh          , Mm          , Hh          , Mm          , Gg          , Gg          , Gg          , Hh^Fp       , Hh          , Gg          
Gs^Fmw      , Gg          , Gs^Fmw      , Gg          , Gg          , Ds          , Gg          , Ww          , Ds          , Ds          , Wwf         , Gg          , Gg          , Gg          , Re          , Re          , Re          , Gg          , Re          , Gg          , Gg          , Gg          , Gg          , Gg          , Hh          , Hh          , Gg          , Gg          , Re^Gvs      , Gg          , Re          , Gg          , Re          , Hh          , Re^Gvs      , Re^Gvs      , Mm          , Re^Gvs      , Mm          , Gg          , Gg          , Hh          , Gg          , Hh          , Gg          , Gg          , Hh          , Mm          , Mm          , Gg          , Gg          , Gg          , Gs^Fmf      , Gs^Fp       , Gs^Fp       
Gg          , Gg          , Gs^Fmw      , Gg          , Gg          , Gg          , Gg          , Ww          , Ww          , Ww          , Gg          , Gg          , Re          , Re          , Re^Gvs      , Re^Gvs      , Hh          , Re          , Re^Gvs      , Re          , Re          , Gg          , Gs^Fp       , Gg          , Re          , Re          , Re          , Re^Gvs      , Re          , Re          , Hh^Vhh      , Re          , Gg          , Re          , Re          , Hh          , Mm          , Mm          , Mm^Xm       , Mm          , Mm          , Mm          , Hh          , Gg          , Rd          , Gg          , Hh          , Hh          , Hh          , Gg          , Gg          , Gs^Fmf      , Gs^Fmf      , Gs^Fp       , Gs^Fp       
Gs^Fp       , Gs^Fmw      , Gs^Fp       , Gg          , Gg          , Gg          , Gg          , Ww          , Ce          , Re          , Re          , Re          , Hh          , Re^Gvs      , Re^Gvs      , Hh^Fmf      , Re^Gvs      , Re^Gvs      , Re^Gvs      , Re^Gvs      , Re^Gvs      , Re          , Re          , Re          , Mm          , Hh          , Gg          , Re          , Re^Gvs      , Re^Gvs      , Mm          , Gg          , Hh          , Gg          , Gg          , Re          , Re          , Hh          , Hh          , Hh          , Tr          , Hh          , Tr          , Tr          , Tr          , Hh          , Hh          , Hh          , Gg          , Gg          , Gg          , Gs^Fp       , Gs^Fp       , Gs^Fp       , Gg          
Gs^Fp       , Gs^Fp       , Gs^Fp       , Gs^Fp       , Gg          , Gg          , Gg          , Ww^Bw/      , Ww          , Re          , Gg          , Gg          , Hh          , Re^Gvs      , Re^Gvs      , Re^Gvs      , Re^Gvs      , Re^Gvs      , Re          , Re          , Re          , Re          , Hh^Fmw      , Mm          , Mm          , Mm          , Re^Gvs      , Re^Gvs      , Re^Gvs      , Hh          , Hh^Vhh      , Hh          , Re^Gvs      , Re^Gvs      , Gg          , Hh          , Gg          , Re          , Rd          , Rd          , Rd          , Rd          , Rd          , Tr          , Tr          , Ch          , Hh          , Gg          , Gg          , Gs^Fp       , Gg          , Gs^Fp       , Gg          , Gg          , Hh          
Gg          , Gs^Fp       , Gs^Fp       , Gs^Fp       , Gg          , Gs^Fp       , Gg          , Gg          , Gg          , Ww          , Gg          , Gg          , Gg          , Hh          , Gg          , Re^Gvs      , Gg^Wm       , Re^Gvs      , Re^Gvs      , Re          , Re^Gvs      , Hh          , Gg          , Hh          , Hh          , Hh          , Re^Gvs      , Re^Gvs      , Re^Gvs      , Hh          , Hh          , Re^Gvs      , Re          , Mm          , Mm          , Mm^Vhh      , Mm          , Tr          , Hh          , Tr          , Tr          , Tr          , Tr          , Rd          , Rd          , Tr          , Gg          , Gg          , Gg          , Gg          , Gg          , Gg          , Hh^Fdw      , Gg          , Gg          
Gg          , Gg          , Gs^Fp       , Gg          , Gg          , Gg          , Gg          , Gg          , Gg          , Wo          , Wo          , Gg          , Gg^Vc       , Gg          , Gg          , Hh          , Re^Gvs      , Re^Gvs      , Gs^Fp       , Re          , Gg          , Gg          , Gg          , Gg          , Gg          , Re^Gvs      , Re          , Re          , Re^Gvs      , Re^Gvs      , Hh          , Re^Gvs      , Hh^Fmw      , Mm          , Mm^Xm       , Mm^Xm       , Mm          , Mm          , Hh          , Gg          , Ch          , Tr          , Rp^Vhc      , Rp^Vhc      , Tr          , Rd          , Re          , Gg          , Gg          , Hh          , Gg          , Hh          , Gs^Fmf      , Hh          , Hh          
Hh^Fmw      , Gs^Fp       , Gg          , Gg          , Gg          , Gg          , Hh          , Gg          , Gg          , Gg          , Gg          , Ww          , Wwf         , Gg          , Gg          , Re^Gvs      , Gg          , Gs^Fmf      , Gg          , Re          , Gg          , Gg          , Hh          , Hh          , Hh^Vhh      , Re^Gvs      , Hh          , Hh          , Hh          , Gg          , Hh          , Hh^Fdw      , Mm          , Mm          , Mm          , Mm          , Mm          , Hh          , Gg          , Gg          , Gg          , Rp          , Rp          , Tr          , Tr          , Ch          , Gg          , Re          , Re          , Gg          , Hh          , Hh          , Gs^Fdw      , Gs^Fdw      , Gg          
Hh          , Hh          , Gg          , Gg          , Hh          , Gg          , Hh^Vo       , Gg          , Dd          , Gg          , Gg          , Co          , Wwf         , Ce          , Gg          , Gg          , Gg          , Gg          , Gg          , Re          , Re          , Gg          , Gg          , Mm          , Mm          , Hh          , Hh          , Mm          , Hh          , Gg          , Gg          , Mm          , Mm          , Mm          , Mm          , Hh          , Hh          , Mm          , Gg          , Mm          , Hh          , Gg          , Gg          , Gg          , Gg          , Gg          , Gg          , Gg          , Re          , Gg          , Gs^Fmf      , Gg          , Gg          , Gs^Fmf      , Gs^Fmf      
Mm          , Hh          , Gg          , Gg          , Gg          , Hh          , Rd          , Gg^Vo       , Rd          , Dd^Fi       , Gg          , Ko          , Co          , Wwf         , Gg          , Gg          , Gg          , Gg          , Gg          , Hh          , Re^Gvs      , Re          , Re          , Hh^Fmf      , Mm          , Hh          , Mm          , Mm          , Hh          , Hh          , Mm          , Mm          , Mm          , Mm          , Mm          , Mm          , Mm          , Mm          , Gg          , Hh          , Hh          , Gg          , Gs^Fp       , Gs^Fp       , Gg          , Gg          , Gg          , Gg          , Re          , Gs^Fmw      , Gs^Fmf      , Gs^Fmf      , Gs^Fmf      , Gs^Fp       , Gg          
Mm          , Mm          , Mm          , Hh          , Gg          , Gg          , Rd          , Hh          , Gg^Vo       , Rd          , Gg          , Gg          , Gg          , Ww          , Ww          , Gg          , Gg          , Hh          , Re^Gvs      , Re^Gvs      , Re^Gvs      , Re^Gvs      , Re          , Hh^Fdf      , Hh          , Mm          , Mm          , Mm          , Mm          , Hh          , Hh          , Mm          , Mm          , Mm          , Hh          , Hh          , Mm          , Hh^Fmf      , Hh          , Hh          , Hh          , Gs^Fp       , Gs^Fmf      , Gs^Fp       , Gg          , Gs^Fp       , Gs^Fmf      , Gg          , Gg          , Re          , Re          , Gg          , Gs^Fp       , Gg          , Gg          
Mm          , Mm          , Mm          , Hh          , Hh          , Hh          , Hh^Vo       , Rd          , Rd          , Gg          , Hh^Fp       , Gg          , Gg          , Gg          , Ww          , Gg          , Gg          , Hh          , Hh          , Hh          , Hh          , Re          , Re^Gvs      , Gg          , Gg          , Hh          , Mm          , Mm          , Mm          , Hh          , Gg          , Hh          , Gg          , Gg          , Gg          , Hh          , Mm          , Hh^Fmf      , Gs^Fmf      , Hh          , Hh          , Gg          , Gs^Fp       , Gs^Fp       , Gs^Fp       , Gs^Fmf      , Gg          , Gs^Fp       , Gs^Fmf      , Gs^Fp       , Re          , Gs^Fmf      , Gg          , Gs^Fmf      , Gg          
Mm          , Mm          , Mm          , Hh^Fp       , Hh^Fmf      , Hh          , Ww          , Hh          , Gg          , Hh          , Gg          , Gg          , Gg          , Gg          , Wo          , Gg          , Hh          , Gg          , Hh          , Hh^Vhh      , Re^Gvs      , Hh          , Hh          , Gg          , Re^Gvs      , Hh          , Hh          , Mm          , Hh^Fdw      , Hh          , Mm          , Mm          , Mm          , Hh          , Mm          , Hh          , Hh          , Hh^Fp       , Gs^Fmf      , Hh          , Gg          , Gg          , Gg          , Hh^Fmf      , Gg          , Gs^Fmf      , Gg          , Gs^Fmf      , Gs^Fmw      , Gg          , Re          , Gg          , Gg          , Gs^Fmf      , Gg          
Mm          , Mm          , Mm          , Hh^Fp       , Mm          , Hh          , Hh          , Hh          , Gg          , Gg          , Gg          , Gg          , Gg          , Wo          , Gg          , Gg          , Hh          , Hh          , Hh          , Re^Gvs      , Gg          , Hh          , Hh^Vhh      , Re^Gvs      , Hh          , Hh          , Hh^Fp       , Mm          , Mm          , Mm          , Mm^Xm       , Mm          , Mm          , Mm          , Hh          , Mm          , Hh          , Hh          , Hh          , Gs^Fmw      , Hh          , Gg          , Hh          , Hh^Fmf      , Hh^Fdw      , Gg          , Gs^Fp       , Gg          , Gs^Fp       , Gs^Fp       , Re          , Gs^Fmf      , Gs^Fp       , Gg          , Gg          
Hh^Fp       , Mm          , Hh^Fmw      , Hh          , Hh          , Mm          , Mm          , Hh          , Hh          , Hh          , Hh          , Gg          , Gg          , Wo          , Gg          , Gg          , Gg          , Gg          , Hh          , Gg          , Mm          , Hh          , Hh          , Gg          , Hh          , Mm          , Mm          , Mm          , Mm          , Mm          , Mm          , Mm          , Mm          , Mm          , Hh          , Mm          , Gs^Fmw      , Hh          , Gg          , Hh          , Gg          , Hh^Fmf      , Hh          , Gg          , Gg          , Hh          , Gs^Fp       , Gs^Fmf      , Gg          , Gg          , Re          , Gg          , Gs^Fp       , Hh^Fmf      , Hh          
Hh          , Hh^Fmw      , Hh^Fmw      , Gg          , Gg          , Gg          , Hh          , Mm          , Mm          , Hh          , Hh          , Gg          , Gg          , Wo          , Gg          , Gg          , Gg          , Gg          , Gg          , Hh          , Mm          , Hh          , Hh          , Hh          , Mm          , Mm          , Hh          , Mm          , Mm          , Mm          , Mm          , Mm          , Mm          , Hh          , Gs^Fdw      , Hh^Fdw      , Hh^Fdw      , Gs^Fdw      , Hh          , Hh          , Hh          , Gg          , Hh          , Hh^Fmf      , Hh          , Gg          , Hh          , Gg          , Gs^Fmf      , Gg          , Re          , Gs^Fp       , Gs^Fp       , Gs^Fdw      , Hh          
Mm          , Mm          , Mm          , Hh^Fp       , Hh^Fp       , Gg          , Gg          , Hh          , Mm          , Mm          , Gg          , Gg          , Gg          , Ww          , Ds          , Gg          , Gg          , Gg          , Gg          , Hh          , Hh          , Hh          , Mm          , Mm          , Mm          , Mm          , Mm          , Mm          , Hh          , Hh          , Mm          , Mm          , Hh^Fp       , Mm          , Hh          , Hh          , Mm          , Hh^Fmf      , Hh          , Hh          , Gg          , Hh          , Gg          , Hh          , Gg          , Gg          , Hh^Fdw      , Gg          , Gs^Fmf      , Gs^Fmf      , Re          , Gs^Fp       , Gs^Fmf      , Gg          , Hh          
Hh          , Mm          , Hh          , Mm          , Mm          , Hh          , Gg          , Hh          , Mm          , Hh          , Ww          , Ww          , Ww          , Ww          , Ds          , Gg          , Gg          , Hh          , Hh          , Gg          , Hh          , Hh^Fp       , Mm          , Mm          , Hh          , Mm          , Hh          , Mm          , Mm          , Mm          , Mm^Xm       , Hh^Fp       , Hh          , Hh          , Hh^Fdw      , Hh^Fp       , Hh^Fp       , Hh          , Hh          , Gg          , Gg          , Gg          , Gs^Fmw      , Gg          , Gs^Fmw      , Gg          , Gs^Fp       , Gs^Fmf      , Gg          , Gg          , Re          , Re          , Gs^Fp       , Gg          , Gg          
Hh          , Hh          , Hh          , Mm          , Mm          , Mm          , Mm          , Gg          , Gg          , Ww          , Gg          , Gg          , Gg          , Ds          , Gg          , Gg          , Hh          , Gg          , Gg          , Gg          , Hh          , Hh^Fp       , Mm          , Mm          , Mm          , Mm          , Mm          , Mm          , Mm          , Mm          , Mm          , Mm          , Mm          , Hh          , Hh          , Gg          , Gs^Fmf      , Hh          , Gg          , Gs^Fmf      , Gs^Fp       , Gs^Fmf      , Gg          , Gs^Fmf      , Hh^Fdf      , Gs^Fmf      , Gg          , Gs^Fp       , Re          , Re          , Gs^Fmw      , Gg          , Gs^Fmw      , Gs^Fp       , Gs^Fp       
Gg          , Gg          , Gg          , Hh          , Ww          , Ww          , Ww          , Hh          , Ww          , Ww          , Gg          , Gg          , Gg          , Hh          , Gg          , Gg          , Hh          , Hh          , Hh          , Hh          , Mm          , Mm          , Mm          , Hh          , Mm^Xm       , Mm          , Hh          , Mm          , Mm          , Mm          , Hh          , Mm          , Mm          , Hh          , Hh          , Hh          , Gg          , Gg          , Hh          , Hh^Fdf      , Gg          , Gg          , Gg          , Gg          , Hh^Fp       , Hh^Fmf      , Gs^Fmf      , Re          , Hh^Fmf      , Hh^Fmf      , Gs^Fmf      , Gg          , Gs^Fmw      , Gs^Fp       , Gg          
Gg          , Gg          , Ww          , Ww          , Gg          , Gg          , Hh          , Ww          , Hh          , Mm          , Mm          , Hh          , Hh          , Hh          , Hh          , Hh          , Hh          , Mm          , Mm          , Hh          , Hh          , Mm          , Mm          , Mm          , Mm          , Mm          , Mm^Xm       , Hh          , Mm          , Mm          , Mm          , Hh          , Mm          , Hh^Fdw      , Hh^Fmf      , Mm          , Hh          , Hh          , Hh          , Gg          , Hh          , Hh          , Hh^Fdf      , Gg          , Gs^Fp       , Gs^Fp       , Gg          , Re          , Re          , Gs^Fp       , Gg          , Hh^Fdf      , Hh^Fp       , Gs^Fp       , Gs^Fmw      
Gg          , Ww          , Mm          , Mm          , Mm          , Gg          , Mm          , Hh          , Hh^Fp       , Mm          , Mm          , Mm          , Hh          , Hh          , Hh^Fp       , Mm          , Hh          , Hh          , Mm          , Hh          , Hh^Fp       , Mm          , Mm          , Mm          , Mm^Xm       , Mm          , Mm          , Mm          , Mm          , Hh          , Mm          , Mm          , Hh          , Mm          , Mm          , Hh^Fp       , Hh^Fp       , Mm          , Hh          , Hh^Fp       , Hh          , Gg          , Hh          , Gg          , Gg          , Gs^Fp       , Gs^Fp       , 5 Gs^Fp     , Gg          , 1 Re        , Gs^Fp       , Gs^Fp       , Gs^Fp       , Gs^Fp       , Gs^Fp       
Ww          , Ww          , Hh          , Mm          , Hh          , Mm          , Mm          , Hh          , Hh          , Hh          , Hh          , Mm          , Hh          , Mm          , Mm          , Mm          , Mm          , Mm          , Mm          , Mm          , Hh^Fp       , Mm          , Mm          , Mm          , Mm          , Mm          , Hh          , Mm          , Mm          , Mm          , Hh          , Mm          , Hh          , Mm          , Mm          , Hh^Fdw      , Hh          , Hh          , Hh          , Hh          , Hh          , Gg          , Gg          , Gg          , Gs^Fmf      , Gg          , Gs^Fp       , Gg          , Gg          , Re          , Re          , Gg          , Gs^Fmf      , Gs^Fp       , Gs^Fp       
Gg          , Gg          , Hh          , Hh          , Hh          , Hh          , Mm          , Mm          , Hh          , Hh          , Mm          , Mm          , Hh          , Mm          , Mm          , Mm          , Mm          , Mm          , Hh          , Mm          , Mm          , Mm          , Mm          , Mm          , Hh          , Mm          , Mm          , Mm          , Mm          , Hh          , Mm          , Mm          , Mm          , Hh          , Mm          , Hh^Fdw      , Mm          , Mm          , Hh          , Hh          , Gg          , Gg          , Hh          , Hh          , Gg          , Gs^Fmw      , Gs^Fp       , Gs^Fp       , Gs^Fmf      , Gs^Fmw      , Gg          , Re          , Re          , Gg          , Gg          
Hh^Fmw      , Hh          , Hh^Fmw      , Hh^Fmw      , Hh^Fmw      , Hh          , Hh          , Mm          , Mm          , Mm          , Mm          , Mm          , Hh          , Hh          , Mm          , Mm          , Ms          , Mm          , Mm          , Hh          , Mm          , Mm          , Ms          , Ms          , Ms          , Ha          , Ms          , Mm          , Mm          , Mm          , Mm          , Mm          , Mm          , Mm          , Hh          , Hh          , Hh          , Hh^Fp       , Hh          , Hh          , Hh          , Gg          , Gg          , Gg          , Gg          , Gs^Fp       , Gg          , Gg          , Gg          , Gs^Fmw      , Gs^Fmw      , Gg          , Gg          , Re          , Re          
